000101110000
011000010000
000001000100
000001000100
000100010000
000000000100
001000000000
000010000000
100010101000
100000100010
100001001001
010010010000
