000101110000
011002222201
333301000100
333001000100
000100010000
000222200100
001222220000
000012222000
100010101330
102200100010
100001001001
010010010000
